C 173,216,230

F 111,78,55

NO ./textures/texture1.xpm
SO ./textures/texture2.xpm
WE ./textures/texture3.xpm
EA ./textures/wood.xpm


1S111
10001
10001
10001
10001
10001
11001
10001
10001
10001
10001
10001
11111
