
C 173,216,230

F 111,78,55

NO ./textures/texture1.xpm
SO ./textures/texture2.xpm
WE ./textures/texture3.xpm
EA ./textures/wood.xpm
111111111111111111111
1W0000000000000000001
111111111111111111111
