NO textures/simonkraft/respawn_anchor_side0.xpm
EA textures/simonkraft/respawn_anchor_side2.xpm
SO textures/simonkraft/respawn_anchor_side4.xpm
WE textures/simonkraft/respawn_anchor_side3.xpm

C 64,64,12
F 128,128,128

1111111111111111111111111
1000000000000000000000001
1000000011100000000000001
1000000000000000000000001
1000000000000000000000001
1000000000000000000111111
1000000000000000000000001111111111111111
1000000111111111100000000000000000000001
1000000111111111100000000000000000000001
1000000111111111100000000000S00000000001
1000000111111111100000000000000000000001
1000000111111111100000000000000000000001
1000000111111111100000000000000000000001
1000000111111111100000000000000000000001
1000000111111111100000000000000000000001
1000000000000000000000000000000000000001
1000000000000000000000000000000000000001
1000000000000000000000000000000000000001
1000000000000000000000111111111111000001
10000000000000000000001          1000001
10000000000000000000001          1000001
10000000000000000000001          1000001
10000000000000000000001          1000001
10000000000000000000001          1000001
1111111111000000000000111111111111000001
         1000000000000000000000000000001
         1000000000000000000000000000001
         1000000000000000000000000000001
         1000000000000000000000000000001
         1000000000000000000000000000001
         1000000000111100000000000000001
         10000000001  100000000000000001
         1000000011    11000000000000001111111111
         100000001      1000000000000000000000001
         1000000011    11000000000000000000000001
         10000000001  100000000000000000000000001
         1000000000111100000000000000000000000001
         1000000000000000000000000000000000000001
         1000000000000000000000000000000000000001
         1000000000000000000000000000000000000001
         1000000000000000000000000000000000000001
         1111111111111111111111111111111111111111